# Iptscrae Keywords file (used as source for KeywordParserMaker
# output list of function templates, list of enums, and switch statement
EXEC			SF_EXEC
ALARMEXEC		SF_ALARMEXEC
IF				SF_IF
IFELSE			SF_IFELSE
WHILE			SF_WHILE
GOTOROOM		SF_GOTOROOM
LOCK			SF_LOCK
NOT				SF_NOT
AND				SF_AND
OR				SF_OR
SETPICLOC		SF_SETPICLOC
SETLOC			SF_SETLOC
SETSPOTSTATE	SF_SETSPOTSTATE
SETSPOTSTATELOCAL	SF_SETSPOTSTATELOCAL
SETALARM		SF_SETALARM
GETSPOTSTATE	SF_GETSPOTSTATE
ADDLOOSEPROP	SF_ADDLOOSEPROP
DOFFPROP		SF_DOFFPROP
DONPROP			SF_DONPROP
REMOVEPROP		SF_REMOVEPROP
CLEARPROPS		SF_CLEARPROPS
NAKED			SF_CLEARPROPS
CLEARLOOSEPROPS	SF_CLEARLOOSEPROPS
SETCOLOR		SF_SETCOLOR
SETFACE			SF_SETFACE
UNLOCK			SF_UNLOCK
ISLOCKED		SF_ISLOCKED
GLOBALMSG		SF_GLOBALMSG
SAY				SF_SAY
CHAT			SF_SAY
ROOMMSG			SF_ROOMMSG
SUSRMSG			SF_SUSRMSG
LOCALMSG		SF_LOCALMSG
DELAY			SF_DELAY
GLOBAL			SF_GLOBAL
DEF				SF_DEF
RANDOM			SF_RANDOM
SUBSTR			SF_SUBSTR
GREPSTR			SF_GREPSTR
GREPSUB			SF_GREPSUB
DEST			SF_DEST
ME				SF_ME
ID				SF_ME
LAUNCHAPP		SF_LAUNCHAPP
SHELLCMD		SF_SHELLCMD
KILLUSER		SF_KILLUSER
NETGOTO			SF_NETGOTO
GOTOURL			SF_NETGOTO
MACRO			SF_MACRO
MOVE			SF_MOVE
SETPOS			SF_SETPOS
INSPOT			SF_INSPOT
ITOA			SF_ITOA
LOGMSG			SF_LOGMSG
SHOWLOOSEPROPS	SF_SHOWLOOSEPROPS
SERVERNAME		SF_SERVERNAME
USERNAME		SF_USERNAME
GET				SF_GET
PUT				SF_PUT
ARRAY			SF_ARRAY
.END
